00000000000000000000111111111
00000000000000000001111111111
00000000000000000001111111111
00000000000000000000111111111
00000000000000000000111111111
00100001000000000000011111111
01000000100000000000001111111
10000000110000000000011111111
00000000001000000000111101111
00000000000100000001101111111
00000000000000000010001001111
00000000000000000001000011111
00000000000000000000000100011
00000000000000000000000100011
00000000000000000001100011111
00000000000000000001100111111
00000000000000000101100111111
00000000000000001000001111111
00000000000000000000011101111
00000000000000000000100111111